35 35 68
15 28
0 0 0
0 0 0
0 0 0
0 0 0
0 0 0
0 0 0
0 0 0
0 0 0
0 0 0
DDDDDDDDDDDDDDDDDDDDDDDDDDDDDDDDDDD
DDDDDDDDDDDDDDDDDDDDDDDDDDDDDDDDDDD
DDDDDDsppppp}ppppp}pppppp}pppppjDDD
DDDDDDsFFFFG!GFFFF!FFGFFG!FFFFGjDDD
DDDDDDsFFFFF!FFFFF!FFFFFF!FFFFFjDDD
DDDDDDsFFFFF!FFFFF!FFFFFF!FFFFFjDDD
DDDDDDsFFFFF!FFFFF!FFFFFF!FFFFFjDDD
DDDDDDsFFF[npn{F[npnnn%FF!GFFFFjDDD
DDDDDDsFFFFFFFFFFFFFFF!FF!n%FFFjDDD
DDDDDDsF[nn%FFFFFFFFFF!FF!G`%FFjDDD
DDDDDDsFFFG!FFFFFFFFFF`{F`FF&{FjDDD
DDDDDDsFFFG!FFFFFF]FFFFFFFFFFFFjDDD
DDDDDDsF[nn!GFFFFFFFFFFFFFFFFFFjDDD
DDDDDDsFFFG!GGFFFFFFFFFFFFFFFFFjDDD
DDDDDDsFFFF`nnnnnnn%FFFFFFFFFFFjDDD
DDDDDDsFFFFFFFFFFFF!FFF"qqqq$FFjDDD
DDDDDDsF%FFFFFFFFFG!FFFjDDDDsFFjDDD
DDDDDDsF!FFFFF%FFFF!FFFjDDDDsFFjDDD
DDDDDDsF!FFFFF!FFFG!FFFjDDDDsFFjDDD
DDDDDDsnpnnnnn!nnnn`FFFjDDDDsFFjDDD
DDDDDDsFFFFFFF!GFFFFFFFjDDDDsFFjDDD
DDDDDDsF[nnn%F!FFFFFFFFjDDDDsFFjDDD
DDDDDDsFFFFG!F`FFFFF[nnppppppFFjDDD
DDDDDDsFFFFF!FFFFFFFFFFFFFFFFFFjDDD
DDDDDDsFFFFF!FFFFFFFFFFFFFFFFFFjDDD
DDDDDDsFFFFF&nnnnn%GFFF[nn%nn{FjDDD
DDDDDDsFFFFFFGFFFF&nn%FFFF!FFFFjDDD
DDDDDDsFFFFFFFFFFFFFG!FFFF!FFFFjDDD
DDDDDDr$FFFFFF%1FFFFG!GFFF!FFFGjDDD
DDDDDDrrqqqqqqrqqqqqqrqqqqrqqqqrDDD
DDDDDDDDDDDDDDDDDDDDDDDDDDDDDDDDDDD
DDDDDDDDDDDDDDDDDDDDDDDDDDDDDDDDDDD
DDDDDDDDDDDDDDDDDDrrrDDDDDDDDDDDDDD
DDDDDDDDDDDDDDDDDDDDDDDDDDDDDDDDDDD
DDDDDDDDDDDDDDDDDDDDDDDDDDDDDDDDDDD
