45 45 68
40 40
66 108 0
0 0 18
0 0 0
0 0 0
30 3 18
0 0 0
0 0 0
0 0 0
0 0 0
DDDDDDDDDDDDDDDDDDDDDDDDDDDDDDDDDDDDDDDDDDDDD
DDDDDDDDDDDDDDDDDDDDDDDDDDDDDDDDDDDDDDDDDDDDD
DDDDDDDDDDDDDDDDDDDDDDDDDDDDDDDDDDDDDDDDDDDDD
DDDDDDsppppppjDDDDDDDDDDDDDDDDDDDDDDDDDDDDDDD
DDDDDDs5FFFFFjDDDDDDDDDDDDDDDDDDDDDDDDDDDDDDD
DDDDDDsFFFFFFjDDDDDDDDDDDDDDDDDDDDDDDDDDDDDDD
DDDDDDsFFFF%FjDDDDDDDDDDDDDDDDDDDDDDDDDDDDDDD
DDDDDDsFF%F!F&ppjDDDDDDDDDDDDDDDDDDDDDDDDDDDD
DDDDDDsFF!F!FFFGjDDDDDDDDDDDDDDDDDDDDDDDDDDDD
DDDDDDsFF!F&n%FFjDDDDDDDDDDDDDDDDDDDDDDDDDDDD
DDDDDDr$F!FFF&%FjDDDDDDDDDDDDDDDDDDDDDDDDDDDD
DDDDDDDsF!FFFF!FjDDDDDDDDDDDDDDDDDDDDDDDDDDDD
DDDDDDDsG!n%FF!F&jDDDDDDDDDDDDDDDDDDDDDDDDDDD
DDDDDDDrqsG!FF!FFjDDDDDDDDDDDDDDDDDDDDDDDDDDD
DDDDDDDDrsF!FF!FF&jDDDDDDDDDDDDDDDDDDDDDDDDDD
DDDDDDDDrsF&{F!FFGjDDDDDDDDDDDDDDDDDDDDDDDDDD
DDDDDDDDDsFFFF&nnnjDDDDDDDDDDDDDDDDDDDDDDDDDD
DDDDDDDDDsFFFFFFFFjDDDDDDDDDDDDDDDDDDDDDDDDDD
DDDDDDDDDrqqq$FFFFjDDDDDDDDDDDDDDDDDDDDDDDDDD
DDDDDDDDDDDDDsFFFF&ppjDDDDDDDDDDDDDDDDDDDDDDD
DDDDDDDDDDDDDsFFFFFFG&jDDDDDDDDDDDDDDDDDDDDDD
DDDDDDDDDDDDDsnn{FFFFF&jDDDDDDDDDDDDDDDDDDDDD
DDDDDDDDDDDDDsFFFFFFFFF!ppjDDDDDDDDDDDDDDDDDD
DDDDDDDDDDDDDsFFFFFFFFF!GGjDDDDDDDDDDDDDDDDDD
DDDDDDDDDDDDDsFFF%F[n%F!FFjDDDDDDDDDDDDDDDDDD
DDDDDDDDDDDDDr$FF!FFF!F!FF&ppjDDDDDDDDDDDDDDD
DDDDDDDDDDDDDDsFF!FFF!G!FFFFGjDDDDDDDDDDDDDDD
DDDDDDDDDDDDDDsFF!FF[}n!FFFFFjDDDDDDDDDDDDDDD
DDDDDDDDDDDDDDsGF!FFF!G&%FFFFjDDDDDDDDDDDDDDD
DDDDDDDDDDDDDDr$G!FFF!FF!FFFFjDDsppjDDDDDDDDD
DDDDDDDDDDDDDDDrqr$FF&{F&nn{FjDDsFFjDDDDDDDDD
DDDDDDDDDDDDDDDDDDsFFFFFFFFFF&ppp{G&jDDDDDDDD
DDDDDDDDDDDDDDDDDDsF[n%FFFFFFFFFFFFF&jDDDDDDD
DDDDDDDDDDDDDDDDDDsFFF&n%FFFFFFFFFFFF&pjDDDDD
DDDDDDDDDDDDDDDDDDsFFFFF&nn%FFFFFFFFFFF!ppjDD
DDDDDDDDDDDDDDDDDDr$FFFFFFF&nnn%==|FFFF|bbjDD
DDDDDDDDDDDDDDDDDDDrqq$FFFFFFFG!bb==d===bbjDD
DDDDDDDDDDDDDDDDDDDDDDr$GFFFF"qsbbbbbbbbbbjDD
DDDDDDDDDDDDDDDDDDDDDDDrqqqqqrDr$bbbbbbbbbjDD
DDDDDDDDDDDDDDDDDDDDDDDDDDDDDDDDrqq$bbbbbbjDD
DDDDDDDDDDDDDDDDDDDDDDDDDDDDDDDDDDDrqqq$1bjDD
DDDDDDDDDDDDDDDDDDDDDDDDDDDDDDDDDDDDDDDrqqrDD
DDDDDDDDDDDDDDDDDDDDDDDDDDDDDDDDDDDDDDDDDDDDD
DDDDDDDDDDDDDDDDDDDDDDDDDDDDDDDDDDDDDDDDDDDDD
DDDDDDDDDDDDDDDDDDDDDDDDDDDDDDDDDDDDDDDDDDDDD
